Éxlip (Mlíxiåz)

eng name -> Exlipian

pronounce patterns:
hr(ā/ē/ī/ō/ū/;) = /ʁ/, /ʀ/
xj = /x/
ãu = /ʌ/
ç = /s/
ř = /ɾ/
x = /ks/, /z/, /s/, /x/
ä, æ = /æ/
ö, œ = /œ/
rr = /r/
q = /k/
e'q = /i.k/, /ɛ.k/, /e.k/
å = /ɔː/
ng = /ŋ/
nj = /ɲ/
j = /ʒ/, /dʒ/, /j/, /ɪ/, /i/
th = /θ/, /ð/, /tʰ/, /dʰ/
 ́ = /²/, /ˈ/ (+ é = /i/)
 ̀ = /⁴/, /ˌ/
ø = /ø/
ch, çh, tsh = /tʃ/
sh = /ʃ/
h = /h/, silent
y = /j/, /i/, /ɪ/
w = /w/, /u/
ph = /f/, /pʰ/

words:
Çlväp - Shop
Krëgå - Train
Xwëvjá
Låçsxë - Temple
…(i)z - ...(e)s (noun)
...(i)s - ...(e)s (verb)
Creádö - Create
Xé - Me
Xígh - Sign
Pebq - build
…íng - …ing
Zxialws
Vímp - Jump
Cälfyç - Craft
Çlåjz - Glass
Çråjz - Grass
Wárs - Word
Bläças - Break
Éxläças - Mine
Dëqz - Done
Plxászë - Please
Máxoçmï - Mobile
Eäpé - Eat
eäpés - eats
Äpéh - Ate
Xawç - What
xawç'y - what's
Háxphëz - Happen
…álj - …ed
Ölçk - Rock
Päpéza - Paper
Çháxa - Chat
Xöçhét - Rocket
Xónnëct - Connect
Långéalë - Language
Xéhy - Sky
Xöllångé - Command
Söq(‘v) - You(‘d)
söqi - your
söqir - yours
söq'ak - you've
söq'vç / sö'vç - you're
Xöap - Soap
Xínglözá - Ingot
Yëarçé - Year
Xómthë - Month
Däçhé - Date
Görlé - Gold
Xíröna - Iron
Xápp - App
Xápplågenlá - Application
Coppéy - Copy
Sxéapher - Speaker
Sçräbble - Scrap
Scalfförçe - Scaffold
Xávler - Table
Oränglexá - Original 
Oxánzgë - Orange
Xéad - Red
Yéallöur - Yellow
Zéxp - Bed
Xöck - Lock
Zún… - Un…
Zúnxöck - unlock
Çuáorzy - Quartz
Xóllabëin - Domain
Xøcoálle - Goal
Xhó - Go
Béxult / Béx - But
Xíthåd - End
Xízláunph - Island
Láunph - Land
Xíçle - Code
Hézrräj - Hello
Xérphåzë - Personal
Hézzajëx - Hexagon
Xíllamoné - Diamond
Xichåle - Chain
Séçrazzi - Screen
Xphråmëxí - Pyramid
Xöráw(j) - Draw(n)
Réxeap - Repeat
…ång - …ly
Sxäzzey - Space
sxäzzeiz - spaces
Zéphillä(j) - Discover(y)
Zläx - Slab
Xíllan - Plank
xíllanb - planks
Slaixë - Stair
slaixëz - stairs 
Zëxer - Dark 
Bósxill - Box
bósxilliz - boxes
Néxla - Hit
néxlas - hits
Xillågëzzïr, Xill - Die(…d)
xillågëzzïrphé, xillphé - died
xillågezzïrs, xills - dies
…eá - …er
Éeryzi - Eye
éeryziz - eyes
Përhy - Pie
përhyz - pies
Hiësrå - Piston
hiësråz - pistons
Fórphë - Phone
fórphëz - phones
Zéxt - Text
zéxtz - texts
Çéll - Call
çélls - calls
Fëx - Fox
fëxiz - foxes
Hëut - Font
hëutz - fonts
yé - yes
Rå - No
Cërçlí - Cancel 
cërçlís - cancels 
Rårj - Nope
Örcéy - Lapis
Érrazy - Lazuli
Ëhy - The
Mxárlí(ap) - Multi(ple)
Péry - Play
péryálj - played
Herrägí - Manage
herrägíley - management
Érph - Pig
érphiz - pigs
Héssy - Sheep
Wérçe - World
Hézrräj, Wérçe! - Hello, World!
Céaköe - Cookie
céaköez - cookies
Félleçlyåtëryoléçeiry(Félly)(…ëgáruxyar(…ëxy)) - Rot(ten)
Gérph - Glyph
gérphz - glyphs
Páy - Pay
páys - pays 
Çrëzírph - Credit
çrëzírphis - credits
Cerrå - Crew
cerråz - crews 
Féldy - Cold
Híryåçkerp - Hot
Fettér - Hotel
fettérz - hotels
Dégg - Dog
déggz - dogs
Exírpheå - Expire
exírpheås - expires
exírpheålj - expired 
Bëyó - Buy
bëyós - buys 
Råyé - Nope
Axí - All
axíz - alls
Exåfy - Every
Bézzy - Body
bézziz - bodies
Séirph - Shield
séirphiz - shields
Råya - None
Exåfyéthigá - Everything
exåfyoxë - everyone
Ezzép - Where
Míph - Map
Fëzzeríph - Furnace
Péullår - Public
Hyëzz - House
Flëaç - Field
Eérjäw
la, l' - a
jlèyy - note
…iëj - …ion
…çå - …en
Héa… - Dis…
Séarj - Smart
thigá - thing
råthigá - nothing
Ké… - Re…
séurriåjleçstäg (séurriåj) - suspend
Tékla - Time
Urjå - Line
Ocçú - Out
Hyí - In
Arróç(al…)(alçé…) - auto(mat…)(matica…)
Arróçalçélång - Automatically
Arróçalç - Automatic
Sírraç - React
E - I
E'zl - i'll
e'lå - i'm
e'jes - i'd
e'ak - i've
Náu - New
náuzëj - newest
Eälp - Old
Eüxeá - Other
Héyyl - Happy
Iérg - Join
lérgíng - joining
Orgzá - Leave
éy - is
Néatl(y)(içof) - Notif(y)(icat)
Swihë - This
Méwyö - Memo
Elåsgezi
Béçla - Best
Citåy - City
Bírç - Back
tú - to
Sérçli - Server
Teglå - Title
Résy - List
Eq - Up
Xéyn - Down
Lérfy - Right
Beuçyá - Click
jez - for
ryms - more
Séury - Show
…avlé - …able
Péxlacy - Prefix
egeåins - again
ryd - and
slyh - last
asço - also
Sryó - Hi
gért - game
Lajr - Menu
sfeíga - single
Óxriëj - option
é’Qurdåy - Quit
Sçárle - Save
géxkorëp - general 
Géxkoraç - Generate
Léjv - Load
léjvíng - loading
Tíragli - Terrain
Coçxerz - Convert
coçxers - converts 
Esråwl - Spawn 
Késråwl - Respawn
Oplét - Open
Sérçtray - Select
sérçtrayálj - selected
Hetry - Empty
Díegå - Demo
Dférgzi - Delete
Zírph - Edit
Svy - Set
késvy - reset
Irçø - Icon
Férg - Fold
Ávç - Are
Sylç - Sure
jéwc - want
jéwcá - wanna
gírb - will
gír'vj / gí'vj - won't
zé - be
Lyrçl - Lost
Hystréag - Long
Fgéajeá - Forever
jf (jif) - of
Recíroj - Record
Bjårsé - Block
Drip - Drip
Lársy - Lase
jå - am 
j (j': if next word start vowels) - it
J'éy - It’s 
Råvj - not
sy - on
Lyv - use
Pläsko - Page
Ljéw - When
Theäq - There
Erja - Here
Tlexíatorçal - Test
Ärflag - Afraid
ujasskorlyawsiå (Ujass) - under
Çlasjår - Stand
ujassçlasjår - understand
Hjårbigge (Hjår) - Who
Egcast - Exact
Kjär - can
Kjä'vj - can’t <-> Kjäråvj - cannot
Xérphå - person
kjasrogéinap, kjasro - crazy
f, f' - if
sá - some
jårn - song
lys - has
lyak - have
Lçass(ez) - name(s)
Suylic - like
säj - say
packross - pain
Ävúrj
…júra - ..ish(language name)
ígljúra - english
sphánjúra - spanish
swíjúra - swedish
ferrajs - french
Sxéaph - Speak
Whártjå - write
calj - candy
Exidë - Side
Éury - How
Ávço - area
Tysín - Tension
Jay - Way
Åljayz - Always
Hejé - Were
Érzy - Else
Wëlçorjal - Welcome
poljt - print
piljt - pin
piljk - pink
pisjk - pick
puljt - push
fuljt - front
lipyk - lip
giljk - ghost
phëz - pen
phëzirgn - penguin 
Kégern - Return
yilör - video
imërg - image
sår - search
asköcy - wife
askåld - avocado
Äsköldest - Amethyst
Cjuld - Card
Çúlkdun - Character
peqrútsukändslårkístosmaklillitstarpiskundendlësmornantsjiústraligonskanalistästreplaskórjened (jened) - bad
jes - would
mán - man
mån - men
wjmán - woman
wjmån - women
jisry - child
Vôy - Boy
ja - girl
Pist - post 
Mil - Male
Fil - Female
Do - Do
Dos - Does
Désj - Did
Do'vj - don’t 
Dos'åvj - Doesn’t 
Ey'åvj - isn’t 
Sjx - Dirt
Sjxg - Dirty
hänbrédonøs - hideous
bitajil - beautiful 
ri - rice
vojk - work
vojks, vojx - works
vojkíng - working
stjd - study
stjdíng - studying
stjdis - studies
Mjskö - Micro
é'Qui - Quick
ques - queue
quez - queues
dölph - dolphin
dölphiz - dolphins 
ésikdric - electric
skådephederada - actor
oxë - one
twj - two
Njal - Three
phø - four
Dir - Five
ség - six 
xévjn - seven
waj - eight
njéin - nine
Jen - ten
jenoxë - eleven
jetwjl - twelve
jenjal - thirteen
jenoul - fourteen
Dirjen - Fifteen
jeség - sixteen
jévjn - seventeen 
jawej - eighteen
jenjéin - nineteen
twi-jen - twenty
twi-jen oxë - twenty-one
njal-jen - thirty
Phøjen - forty 
Phøjenoxë - forty-one
Phøjenid - forty-two
phøjenjal - forty-three
phødéphø - forty-four
phøjedir - forty-five
phøjeség - forty-six 
xévep - forty-seven
phøwaj - forty-eight
phøjenjéin - forty-nine
Dijen - fifty
Ségin - sixty
Xévjl - seventy
Wajen - Eighty
Njen - ninety
bj - by
Téklaz - times
Jenéklazen - hundred
jenéklazenz - hundreds 
oxëz - ones
twjz - twos
njalz - threes
phøz - fours
Nem - negative
Pém - positive
Nemz - negatives
Pékj - positives
Héz - He
Hé'y - He’s 
Hija - His
Sjz - She
Sjz'y - she’s 
Siza - Her
Xú - Why
Jáz - at
persj - press
Éduzz - issue 
éduzziz - issues 
par - private
iérjs - only
qirt - juice
çåk - cake
Hjla - hat
käp - cap
mîg - cup
çelálj - called
amiz - friend
amig - friends
Esj - My 
yuzlj - usually
njsé - nice
mjlt - meet
njsé tú mjlt söq - nice to meet you
Ithorä - another
síw - too
Kjl - cute
gœd - good
ljck - luck
Gœd ljck - Good luck
culps, culéps - collapse
öh - oh
úh, úah - uh
swélzskä - sorry
cät - cat
gwís - guy
gwíz - guys
mäj - may
Mäjbea - maybe
o - or
niáu - noun
vírr - verb
íezz - exit
íezzálj - exited
íezzíng - exiting
brjä - bruh
drrá - damn
vír - very
sœ - so
syurjå - online
di - off
diurjå - offline
Birvil - visible
birvilitj - visibility
vés - west
ís - east
thús - south
táz - north
awé - know
avé - known
awés - knows
awéavlé - knowable
swíg - edge
swígz - edges (noun)
swígs - edges (verb)
awéliswíg - knowledge
awéliswígz - knowledges
awéliswígavlé - knowledgeable
kawéliswíg - acknowledge
kawéliswígs - acknowledges 
kawéliswígíng - acknowledging 
kawéliswígalj - acknowledged 
kawéliswígley - acknowledgement 
kawéliswígleyz - acknowledgements
…ley - …ment
tympláx - template 
tympláz - templates
çäldig - config
çäldigúr - configure
çäldigúrïng - configuring
çäldigúriëj - configuration
çäldigúriëjz - configurations
çäldigz - configs 
prizít - gift
rípiz - present
rípiziz - presents
rípizalj - presented
rípizíng - presenting
rípizitiëj - presentation
rípizitiëjz - presentations
æd - ad 
ædz - ads 
ædvís - advertise
ædvísíng - advertising
ædvísálj - advertised 
dœp - drop
júai - dry
vítt - wet
víttíng - wetting
víttálj - wetted 
yo - yo
hëj - hey
Axír - admin
Axírrat - administrator
dirra - idea
zied - read
fil - file
filz - files
síth - think
bícæz - because
cáz - cuz
äst - late
ästí - latest
väziëj - version
niêd - need
quaí - okay
quaíálj - okayed
dagräs - damage
dagräz - damages
dagräsálj - damaged
tzírj - ...lty / ...lity
aquíçerk - access
aqiíçerkálj - accessed
aquíçerks(verb) / aquíçerkz(noun) - accesses
aquíçerkíng - accessing 
aquíçerksivlé - accessible
aquíçerksivjlétzírj - accessibility 
dískj - difficult 
dískjtzírj - difficulty 
búsizjk - button 
bœd - bound
síghél - suggest
síghélálj - suggested
síghéls - suggests 
síghélíng - suggesting
síghéliëj - suggestion
lätúral - literal 
lätúralång - literally
Néjuit - Nugget
Néjuitz - Nuggets
jæll - jail
näjl - near
näjlbj - nearby
çlasjårbj - standby
énjásu - sleep
énjásíng - sleeping
énjásus - sleeps
bötgh - bought
bhrīgt - bright
bhrīgtång - brightly
ståp - stop
järl - war
särn - sad
särnång - sadly
särndíng - saddening
särndálj - saddened 
phîr - feel
phîrs - feels
phîríng - feeling
phîríngång - feelingly
fímus - famous 
fímusång - famously
Pjärren - problem
Pjärrenz - problems
Länné - channel
lännéz - channels
bjœvíng - boring
pläsk - place
pläskz - places
pläskálj - placed
si - see
silj - saw
thrānslæt - translate
zelrja - god
skjw - skew
skjwálj - skewed
skjwíng - skewing
xjésãu - just
lígúa - ice
lígúaz - ices
lígúálj - iced
bljézz - blue
grihr; - green
çjal - cyan
pìzxjúr - purple
bjäss - black
bjässez - blacks
Aljëská - America
Sxjäin - Spain
Lhrāç - France
Kälíe - Korea
Tshígìz - China
Åscràlla - Australia
Ekígda - United Kingdom
Táz Kälíe - North Korea
Jáp - Japan
Swédihr; - Sweden
Cázj - Canada
Nörjé - Norway
Ímadish - Indonesia
Tskélå - Tokelau
Jérrp - Germany
Hrūssja - Russia
Ukbässya - Ukraine
Thäj - Thai
Vítnä - Vietnam
Jaúzj Arrìzk - Saudi Arabia
Åsk-tsäckj - Austria
Mlëzkja - Malaysia
cåtçid - country
fhrīgh - foreign
enútshâ - enough
xjéz - yet
tjärt - tough
…zëj - ..est
tjärtzëj - toughest
tjärteá - tougher
tjärtz - toughs 
tzérh; - touch
tzérhíng - touching
tzérhàlj - touched
tzérhīs - touches
skådephe - act
skådepheiëj - action
purld - popular
sykäb - should
sang - sand
sangz - sand
sjúk - soul
sjúkz - souls
srkàpt - script
srkàptz - scripts
srkàptàlj - scripted
dëxj - dude
grrurh; - bruh 
jäd - was
s'chjéz - stream
s'chjézis - streams
s'chjézíng - streaming
qíma - team
qímaz - teams
kjzk - key
zíw - size
xímak - xenon
súk - shut
súkxéyn - shutdown